id	seq
ps_bridge1	CACTCCAATCACCAAATAACAACCATCTCATTCCTTTCATTTACCA
ps_bridge2	TCAATTTCACCACAAACCTCATTTCTAACTCACAACCTCCTACTTA
ps_bridge3	AAATCTTCACCAAACCACTAAACCTTTCCTATACCACCTAACCTAA
ps_bridge4	ACACACATCAAACCTTTCCTCCATATCACATCCATCAACTTAACCT
ps_bridge5	TTCAAATCACTCCACACCACTAAACTACCACACTTCCAAATCTTAT
ps_bridge6	TATTTCCTCACAATTCCACTCACACTCTATCATTACACTCTTCCAC
ps_bridge7	AAATTAAATCCACAACCTCTAACCACTCAATCCTCACCAAATTCAT
ps_bridge8	TCCACTTAAACCAACAACTCAATCTCACCAAACTTAATCACCAACA
ps_bridge9	AACCACCACTCATTAAATCCTTCCATCTACCACCTAAACTTCATCA
ps_bridge10	CCACAACATACACTAACAATCACTCCTTTACATCCTCCAATCACCA
ps_bridge11	CTACATTCCATCAAACTATTCAACCTCAACACCATCTTCTCCTTTC
ps_bridge12	TACCTTAACAAATCACACTATACCAACAACTCCACACTCCTCATAC
ps_bridge13	ACTCACATCTTCTTCCATCTCTTACACCTACAACTTCAACCTACAA
ps_bridge14	CTTCCAACCACTCCTCACAATAATACACCAAATCTTCTCAACTTTC
ps_bridge15	ACTATTTCTCCTATACTCAATCATCTCCATTCTCCACACTCCTTCT
ps_bridge16	CTTTAAATCTCTCTCACCTATCCTACTCATCCAACCACCTATCACC
ps_bridge17	CTTCAACATCTCATAACATCTCCAATCCAATCCACACAAACCACCA
ps_bridge18	CCTCACCATCCTTCTAAACATCCTTACATCTAACAATTCCACCTCA
ps_bridge19	TTTCATACTCTCTCCTCTCAATTACCTCCTTCAACAATCCATCCTA
ps_bridge20	CATCATTTCCACACTAAACCTCTTACACTTCCAATTTCCACACTCT
ps_bridge21	CAACCAAATCTTATTCAACACTCCTCCTTTCCACTTAATACCACAA
ps_bridge22	TCATTTCCACCTATCTCAACCTTCTCCTTCACTCCTCACACACAAC
ps_bridge23	CTACAACTCTTCTACCTCTCATTCCTCTAAACATCCACCATCAACC
ps_bridge24	ACAACCATCACCTCCTACCACATTCTTACCTACACTCTTCTATATA
ps_bridge25	CAACCTCACTTCCTCAACTAACCTTTACTCCTAAACAACTCTACAA
ps_bridge26	ACTCCATACCTTACCAACTATACTCCACTTCACCAACATCCAATCT
ps_bridge27	CCACACAATCTCACCACCATCCAATACATCATTCCTATCTAACTCT
ps_bridge28	AATCCTTACTCATACATTCACCACTCAAACACCAACCATATCACTT
ps_bridge29	CTCATTCACATTACACTCAACCACTAAATACCACCACTCATCATCC
ps_bridge30	TACATCCACCTCACAAACACTTTCCACTCCTCACACTACTAACTAC
ps_bridge31	CTTTCTCACTCACTCCTAATTCAACTCACTTCCTACAACAATACCT
ps_bridge32	TACATCATCCACAACTATCCTCCACAATCTTACTTCCTCCTTACAA
ps_bridge33	ACCTCTTCCTACACCATTCACCTTATCCTAACATCTAACCATATCA
ps_bridge34	TCCACTTCTTCACCATCACACATTTCTCCTCCATATCTTTACAACC
ps_bridge35	ACCTCTCACTTCACCTTATATAATACATCCACACATCCTTTCACAC
ps_bridge36	CAATTCCAAACCACATTCAATCTCTTTACCACACAAACAACCTAAC
ps_bridge37	TTTCAAACAACCAAACCATCCAACTCACCTTATCTCATTTCTCACC
ps_bridge38	TCTAACACCAACTCACACACCTATACCAACTACCTCATATCATTCC
ps_bridge39	TTACTTTCCTCCAACACTAATCTATTCCAATTCACAACCACCATCA
ps_bridge40	ACTTCACTACTTCATCCATCTCTACTTCAACTCCACCTTTCTCTAT
ps_bridge41	CTTTCAAATACCACCTACAATCCTACCACAATCTCCAATCCACTAC
ps_bridge42	CCTCCTTATCAATTCATACTCCACCACATTCAAACACACTCCATCC
ps_bridge43	TCATCCACACACACTATACCATTTAACCTCAACCATATCACCAATT
ps_bridge44	CTAATCCAACCTCACCAATCTCACTTTCCTTCTCCATACACCTCTA
ps_bridge45	TCTCTTATTATCCATCACTTCACCACAATTTCACCATCTCCTACTC
ps_bridge46	ACATAACAACCACAACTCACACTCTCACAACCATCCATCAATAATA
ps_bridge47	TTTACTCTCACCTCAATACACCATCACTTCCTATACTCACCACTCA
ps_bridge48	CCACTCTTACCTACACCAACATTTAATTCACAACTCAACCAATCTT
ps_bridge49	ACCTCACTCACTTTCACCTCACTCTACAACTATTACTCCATTCATT
ps_bridge50	CACCTTCAACCTACCACAAACTATTTCCTACCACTCATACCACTAA
ps_bridge51	CTTCCATCATTCAACCAAACTCCTAACCTAAACTCACCAACCTACC
ps_bridge52	CTCTCCAACTTTAACCTAACAACAATCACTACTTCCACACCAATCA
ps_bridge53	CTCTTCATACCATCTATCAAACTCCTCCAACCAACACACTACCTTC
ps_bridge54	CCATCCATCCTTTCTCATTCCAACACTCCATCCAACTATTTATCTA
ps_bridge55	TAATTTCCTCAATCTCCAACCACATCATTACACACATCCTCTTCTT
ps_bridge56	TCCACATCCACCAAACCTATCACACATTTCTTCAACCATCTAACCT
ps_bridge57	CCACCATTTCCTCTACAACCTAACATACTTTCTAACCACACCACCA
ps_bridge58	TTCTTTAAATACCACTTACCAAACAACCTCTCACAACTAACCAACC
ps_bridge59	ACACTTTCTCTAACTTATATACACCTAACCTCCATCTCTCACCACC
ps_bridge60	ACACAAATTACCACATTCCACACTCACTTACACATACTACTCTACA
ps_bridge61	TCCACTCAACATCCTTTACCATTCTTCCTCAAACAAATCACACCAT
ps_bridge62	CCAATACTCCTCTTCATTCCTCTACACCTTAACTAACCTTCATTCC
ps_bridge63	CTCTCCACACCTATCTCTTCAAATTTCCTAAACCAATTCCATCTCT
ps_bridge64	TAAACCACCTTCTCTCACTTTCACCTCTTTATCTACTCTCTTACCT
ps_bridge65	TATCCAACTAACCACCTACCATCACTTAACATTTCATACCACTCTC
ps_bridge66	ACTTCATACTCCTATACAATAACATCCATTCTCCAACCACCTCACC
ps_bridge67	CTCATACCTTCCAACCTTACTCTCATAACTACAATCACCTCTCCTT
ps_bridge68	TATTCACCATCACCTTAAATCTCACCAATTCCAAACCAACAATCTT
ps_bridge69	TCTTCACCACACTCATCTACACTTTCTCTCCATACTCTATCCAATT
ps_bridge70	ACAATTCTACCTCTTTCAACTCTCTTCTCCTCTACCATCACCAACA
ps_bridge71	ATCACCTTCCAATCAACCAACCTCAAACTATCTTTCTCCTCATTAT
ps_bridge72	TCCTACACTCTTCCTCACTCAAACAATTAACTTCCAATCAACCTCT
ps_bridge73	TCACATCCAAACCTTACATCCTCCTCACTTTACCAATTCTACCACA
ps_bridge74	CCTCCTTCCTACTTATTCTACCACCTCACAACCATAACCATTACTT
ps_bridge75	AACCTCCAACACTTTCTCTCCAATCTTCCACACCATACCACTTACA
ps_bridge76	CCTCCACAACAATACCTCCTTTCAAATTACCAACCTCACACTATTT
ps_bridge77	CACCTAAACTTCCTCTTCACATCAACACTTCCTACATCCATCATTA
ps_bridge78	TAATACCAACACTACCATCACACCAATTACTATCAACTCACCTACC
ps_bridge79	TTCCATCTTAACTCACTTTCACTCAACTCAACAACACAAATCAACA
ps_bridge80	ATCAAATCCTACTCATATACTCTACTCTACACTTCTCCAACCACCA
ps_bridge81	CAACTTCCACATAACAACCTCAACACTCTCCTACATTTCAACCTAT
ps_bridge82	ACCACCATCCTTCAATACCACACTATCTAAATCCACACCTTCTTCT
ps_bridge83	CCTAAATCATTAACCTCTCAACACTTCAATCACACACACTTTCCAC
ps_bridge84	ACTTAATCCAATTCCACCAACCTTTAACTCCATCATCAACCTACTC
ps_bridge85	ACATTCTTCCTCACCTATCCTCCTCAAACTACCTCCTACTAATTTC
ps_bridge86	TACCACACCAACAACCTCAAATTCACTACCACTATTTCCATATCCA
ps_bridge87	CCTCTTTCTCTACTTTCTACCTAAACCACAAACTCCACAAACAACC
ps_bridge88	AATCCACTAAACACCTAACTCCATCTCCACATACTACCAATCCAAC
ps_bridge89	ACATCATTCCATTAACACACTCCTTCAACTCACTCCTCTTAATTCT
ps_bridge90	CTTCCTCTCTACTCTCACTACCACCTACACTATACACAACATACCT
ps_bridge91	TACACAACTCACTACACATCTTTCCAAACATCTCACCTTTCTAACA
ps_bridge92	TTCACTCCAACTTAACAACCACAATACTCTTCTCAATTCTCTTCCT
ps_bridge93	CTCCTCTTATCTCAACACCTCAACTAAACCACATTCCAACTCAACT
ps_bridge94	TTTACTTACATCTTACCTACCTCCTCTCCATCCAACATCAAACCTT
ps_bridge95	TTATCTCTTCCATCTTACCATCACTCAACCAAACTCCACTCCATTC
ps_bridge96	TCTCCAATCACACCTAACTACAACACTTAACCAACCTATCTTCATT
ps_bridge97	CCTCTCCACTCCTTACTTAACCACTTTACAACTTCCAAACTTCCTT
ps_bridge98	CCAATATCCAACAACCATTCAATCTATCTAACCAACTTCCTCCAAC
ps_bridge99	TCACACTCCACACCATATCTCCAATAATCCATCAATCCACACCATA
ps_bridge100	AACATCTACCACCAAACTCATCCACAATCCATTCATTCATTACTCT
ps_bridge101	TCACTACATCCATAAATCACATACACCTACCTTCCTCCTATATCCA
ps_bridge102	TCATCTACCTAATCTCCTTCTCATCAATCATAACTCACTTCCTCCA
ps_bridge103	TCTCACACACCTTATCTTACTACCACCTTACTTATTCCACCACAAA
ps_bridge104	CATAACCATTACTCCATACCTTCCACTCCTATTCCACACCAATAAC
ps_bridge105	ATCTTTACACCAACAACAACCACTACTCCACAACAAATCAAACTTA
ps_bridge106	CATTTCATCCACTATTCTCATCCACCTCCAAACATTCCTCACCAAA
ps_bridge107	TCTACCTCTTCATCCTCTCCAACTATCCAACTCATATCTAACCATC
ps_bridge108	CCTTCCTTACCAACAAACTAACACTATCACTTCCACTTCACCTCTC
ps_bridge109	CAACCTCTTACTTAACTTCAACTCAACCTCTCCAACAACTCTTACT
ps_bridge110	ATCAACACCTCTTCCAACACATCCTTATACTCCTCACCTACATTCC
ps_bridge111	TCCACAAACTACTTACCTTCTTAACCTCTTCCTACAATTCCACACC
ps_bridge112	TCACTCTCACTCAAACTCTCATACTAACAAACACATCCATACCACA
ps_bridge113	TCCTCAATTTCCACCTTTACCTCTTACCTCCAAACTTCTCACTACT
ps_bridge114	AATACCATCATCAACACACTATATACTCTCTCCACCTTCATCCTCT
ps_bridge115	CCAAATCCTACCATACCACCTATTCCACCTCATTATATCATCCTCT
ps_bridge116	TCTCTTCATCCAACCACCATAATTTCTACCACAACACTCCTTAACT
ps_bridge117	CCTCCACCAATTACACACTCTCTCCTCTACCTTATTACATCATACT
ps_bridge118	TCATACACACCAACATACCACTCATCTCTACATTCTCTCCTACACC
ps_bridge119	ATATCTTCATCTCCATCATCACACCTATTCACTCACTTTCCAATCC
ps_bridge120	CTATCCACACTCACTCCTCTCATCAACTACTTTCCTCACAATTCTC
ps_bridge121	CCACACCTTCCAACCTCCACTATAACCATTTAATTCTTTAATCACC
ps_bridge122	CCAACATCTCACAATCATTCCTCCACCATCTATTCTTATCCAACTT
ps_bridge123	TCCACACCAACATTCACAATCCATTATCACCTTCAATATACTCCAA
ps_bridge124	ACAATCTTCACTACCACCACTAACATCTCAACTCCAATCTCATCAT
ps_bridge125	ACTTCTCACATTTACCATCACCATCCATATCCACTTCCATTCCATC
ps_bridge126	CCATCATCCAATCTATCATAACCACCTACTTTCCATCTCCAAACAA
ps_bridge127	TACTCCACAATCCTTATTCACTCACTCATTTCAACCTTCATCCACT
ps_bridge128	TTATTCCATACCAAACCTCATCACATACATCCACACACCAACTTCA
ps_bridge129	TTCATTCAACCTCCTTCTCCTCATCCAACTCTAATTTACACTCCTA
ps_bridge130	CCATAATCTCTTCCACTATCCATATCAACTCCAACCACCTAATACC
ps_bridge131	TCTTCAATACATAACCTCCTTTAACCATCCACAAACCATCCTCCAT
ps_bridge132	TCCACACCAACATCTAACCTCACCTTCATCATCTCTCTAAATTTAC
ps_bridge133	TTTCATCTTACCTTACATCACATTCACTTATCCACATTCCACTCCT
ps_bridge134	ACACATTTATCAACTCCTTATCAACACTTCTCCATTCTCCACAACC
ps_bridge135	ACAATTCTACTACACCTAAACCTAACACATCCTACACAACCAACAC
ps_bridge136	ATCAACCTCACTTCTCCTACATCCTTCACACCTTCAATCAATTCAA
ps_bridge137	CCACCTTTACATCTAATTCAACTTACCACTCACCACACTTTATCCT
ps_bridge138	TCCTCCACCATTCACACACTCAAATCTTCCATTTATACATTCTACA
ps_bridge139	AACAACCATCAACACACTTATCACCTCCTATAACTCCTTCCTCAAA
ps_bridge140	ACCTCCACTTAATCTTACACACCAACTCTCTTACATTCTCTTCTCA
ps_bridge141	TCCTTATCATTCCTCTCCACACTCAAATCCTCACTATCCAACACCA
ps_bridge142	TCTCCTTCCTATCACACACTTCTCACCATATTTCAATCATCACCAT
ps_bridge143	TTCAACATTCACTACACTTCCACCTCACTAACATACATTCAACCAC
ps_bridge144	ATTCACCAATCCTTCCATCACTCATCAACCATCTATTCTATCCACC
ps_bridge145	CACATCATTCACTCCTTTCCACCTCCAATAACACAAATCACCAATT
ps_bridge146	CATTCACTCCAACCAACAAATATACACACTACCTTACATCCTCCTA
ps_bridge147	ACACAACCAATTACTTACAACATTTCACTCAACACTTCCACCACAA
ps_bridge148	TTCACAATCCATAAACCTTCTACCTTCTACACCACCAACATTCATT
ps_bridge149	ACTCCTTTATCAATCAACTCAAACACTCTTTCAACCACATCCTACA
ps_bridge150	CCTTCTATTTCTCAACTTCCACACACCTAATCCACACCAAACAATT
ps_bridge151	TCACTACATACATACCATAAACCACACTACTTCTCCACACTTCCAC
ps_bridge152	TCCTACACTACACTCCAATACTTACTTCCAATTCCTTCCTTCTACA
ps_bridge153	CCAACTTCCAATTCCTCTTACTTCCTCCTCTCCTCCTACACTCCTC
ps_bridge154	ACACCTCCTCAACCTAACCTTCTTTCCTCTCCATATATACACTTAA
ps_bridge155	CCAAACACCATCCTTCAACATTTCAACATTCATCTCTCCATACAAA
ps_bridge156	CCACTTCCATACCAATCAATCCTACCATACACCTTCTTTCTCATCC
ps_bridge157	AAACACCTCATACATAAATCACCTATCCACCTCAACCATTCCTCTT
ps_bridge158	TCCTTTCCAACACCTCAATAACATTTAACACCAATTCCTACTACCT
ps_bridge159	AACACACCACTCAAACTCTCACTAATCTCCTCTCCAAACAAATTCT
ps_bridge160	ATATTCAAATCCTCCTCCATCATCTCATCAAACATCACTCTCCATT
ps_bridge161	CCTCCTCCTTTATCCTCATCATACTCTCCTCACACATCATACTTTC
ps_bridge162	ATCACCATCACTTCCATTTACTCTCACACTCCATTACTACCTCAAT
ps_bridge163	AACTCCTCTCACTCCACCATATTTACACCATTCACCTAAATCAATC
ps_bridge164	AAACCAACCTCCTCAACATCATATCCACACTATACCTAACTTACAC
ps_bridge165	TCTCCTCTACACACACTTCACTCATTAACCTTCCATTTCTTCCATA
ps_bridge166	ACAACATCCTACATCTCCAACAAACAATATTATTCCACCACCACAC
ps_bridge167	CTATCCATAACTCCAAACTTCTCCATCCTCTTCCAACACTCTCACT
ps_bridge168	TTACCAATCATTTACCTTCACACAACCAATCCAACCTATTCTCCTT
ps_bridge169	ACACAACCTACTACTCACCATTACACATACTCACAACATAACCAAA
ps_bridge170	ACCTCCTTTCTCACCATCCACTTAAACCTTCCACTATCCTCATTTA
ps_bridge171	CTTACTAATCACTCCAACACTTCATTCATCCAACACCTCTACCATT
ps_bridge172	AAACAAATCCATCCTCACATCCACACATAAACCAACACATCCTTTA
ps_bridge173	TCCAACCTACAACATCACATCCATCTCCATACCAAACCTCCACCAT
ps_bridge174	CACACATAACCTTAATACACCTTCTTTCACTCTACCATCCACACCT
ps_bridge175	CCACATTCATAACTTCTCTCTCCTAACCAAACTCCACACTAAACCA
ps_bridge176	ACCTAACAATCAACAACTTCACACCAACCTATCACTCCATAACATA
ps_bridge177	CTCTCACTTCCTACACCATCACTTAACACCACTCAATCTCTACTCA
ps_bridge178	TCACCTACCTCTCTCTCCACTTATATCAAACATTCCAACACAACTC
ps_bridge179	CCACCTATTCTTATCCAATCTACCACCTAACAACTCCTCTTTCAAA
ps_bridge180	TCCTATCCAACTCATACTATAACCAATACCACCTCTCACATCTCCT
ps_bridge181	CACCAAACAACTCCTTCCATCAACCAAACAATCTCACTAAACTTAA
ps_bridge182	CTCTCTCTATATCCACTAACCTCTTCTCTCCACCAATCTTCACCTT
ps_bridge183	ATTACACCTTCTTCCACTACATTACACCAACCTATCCACTCTCTAA
ps_bridge184	TCCTCCTCTCCAACAACTAATCAAACACCTCTCTTTAACCACTACA
ps_bridge185	ACAACCTTCATCTTCCACCACATTCTCAAACACCTACATTACCTTA
ps_bridge186	TATACACCTCTTTAACCACCTACCACATCAATCCTCTCTCCATACA
ps_bridge187	TCCTCACCACAACTCACTAATTAACCAACAATTTCTTCCACACCTC
ps_bridge188	TCAATCCTCCTAACCTAACTTCTTAAACCTCTCACTCACTCCTTAA
ps_bridge189	ACAACTCCTCACTACCTTATTAACATCCTTTCCTACCACATCACTA
ps_bridge190	ACAACCTTCTCTTCTTCCATACCATATATCCATTCCACACTTTCTT
ps_bridge191	TCCAACTCCAAACCAATTCTTATATCCTTTCCACCACAACATTACA
ps_bridge192	CTACACCTATCACCTTAAATCACCTTACACCTACAAATCTCCTCCA
ps_bridge193	TACTCACTCCTACAACCACTCATCATCATATTCAACACCAAACTCA
ps_bridge194	CAACTCTTCCACCTAACCTTAACTTCTTCACACTTAATTCCTCCAT
ps_bridge195	TAATTATCACCAATTTACCAATCCTTCATCCTCTCCAACACACACA
ps_bridge196	ATCCACCTTTCATTCCTCATTTCACACCATCTTACTCCTTACAACA
ps_bridge197	CCACACTCTACACCAATTCCATCAATTCCTCTTAAATCACCATCTT
ps_bridge198	ACCTCTCAACATCACCTCCTTTCACACTTTAACCTATTCTTATCAT
ps_bridge199	CTCTCCACAAACCACTAACCTCCATACATTTCCTATCCTCCTTATA
ps_bridge200	CTATAATCACCTTTCTTCATCCACTCCTTTCCTTAAACCAAACCAC
ps_bridge201	TAATCATCCTCACAACACAATACCTTCTCCTCAACTACCAAATCTT
ps_bridge202	ACATAACACCTAAACCAATTCCAACCACTCCACTTCTAAACAACAA
ps_bridge203	CAACTCCACTTTATTCCAACCTCCTTCCTTACTCCACTAACATTCT
ps_bridge204	ACAAATCATTCTCACCAATCTTCACCTTAATATCCACTCCACTTCT
ps_bridge205	CCTACCTCAACAAATTCCTACCTATCTACCATCCTCAAATTTCCAA
ps_bridge206	CCTCACATAACATCTCATCTAACCTTTCCACACTCTCCTCACCAAT
ps_bridge207	ACATATCTCTTCATCCATCACCAACCTCATCATATCAATACCACCT
ps_bridge208	CACTTCACATCTTCAACCAACCAACATACTCCATACAAATTTCCAT
ps_bridge209	CTTCAACCATCCTCACACAACTATCCAACACATACCAACAATTAAA
ps_bridge210	CTCCATTCCTTACTTCAACTTCACCTCCTAACATCACTCATCACTC
ps_bridge211	TCATCTTATTCACAAACTCCACACCATTTATCACACTCACACACCT
ps_bridge212	TTACATCAATCATACACCTCACACTCTCACACTACACCAATACATT
ps_bridge213	TCACCTATCATCATTCTCCATACACTAACCACCTTCTTCCATTACA
ps_bridge214	AACCACTCCATCTTTCACTTTACTACTCTATACCACTCATCATCCA
ps_bridge215	TCCTCATCTATCAACTCCATCACAACCTTCTCACATTCATAACCAC
ps_bridge216	ATCCACATTACACCACTCTTCCTCTTTACAATACAACCAACATTCT
ps_bridge217	CTTCACCATCCACATCACACCAACTTATTCTCCACTACACTTACTA
ps_bridge218	TCACCACACATCAATCTCTCCTAAACACATTACTCACTCTCCATCC
ps_bridge219	ATCTTCCTCACTCCTTCAATTATACTCCTATTACCACTCCTACCAT
ps_bridge220	TTCAACACCATCTACCATACACATTCTACTCTCACTTAACACAACT
ps_bridge221	TCTCCACTCTATTCTCAACCAAACATTCATAAACAACTCCTACCTC
ps_bridge222	CTTCTACCTTCTTTACCTCAAACTAAACACATCTCTCTCCTACCAC
ps_bridge223	CCATATCATCTCCACTAATCTCTAAACTACCACCACCATACCACTA
ps_bridge224	CACACATCACATACAACCTCATATTCCTTCCTCACCACTCTCAATC
ps_bridge225	CCACAAATTATCTTTCACACCTCCATTCTTCCATACCTATCACCAT
ps_bridge226	ATTTCTTCATTTCCATCTCTTAACACTCACCATTCCTTTCCACAAA
ps_bridge227	CTCACCTACAACCTACCAAACACTCCACTAATTTACCTCTCTCTTC
ps_bridge228	ATCCTACAATCTATCCACACCTCACTAACCATACTCCTCTTCTTCT
ps_bridge229	ACACACTAAATTCTAACCACCTTCCAACCATTTACCTTATTCCTCT
ps_bridge230	TCACAAACACCATACAATCACTTATCATTCCTCTCCATTACACTCA
ps_bridge231	CCTCTAAACTTCCTACCTTTCTAACTCACATTCTCACATACAACCA
ps_bridge232	TATCAAACCAACCACACACACATTTAATTACCATCCTCCTACTCAA
ps_bridge233	TTTCTCCTCTACCACATCTCTTATCCACTTTCCTTCCACTTAACAA
ps_bridge234	CTCACACCTCTCTTCATTCACCATTCACAATTAATCTACCTCCAAA
ps_bridge235	CAACACATCACTTTCCATCACTCCACCTATTTATCTACCACACACT
ps_bridge236	CCACTCCTCACAATCTTCCTCACAATCAAATCTCTTTCCTCTCTCT
ps_bridge237	CTCATTCAAATCTACTCCTCTACACATCCTACAACTTTCCTTCCAT
ps_bridge238	AAACCATAACTTCAACATCTTTCAACCTCCAAATCTCTCTCAACAC
ps_bridge239	TCAATACTTCCTAATCCTCACAACCTTTAATTCACACTCCATCACT
ps_bridge240	CCACCTCATCTACACACAATATTTAAACCAATCCACACATCTCCAC
ps_bridge241	ACACCACCATTCTACTTCCACTTACCACTATCTTAACTCATTAACC
ps_bridge242	AACATCAACTAATTTCCTACCTCCTTTCACAATCCTCTACCAACAA
ps_bridge243	AACTCCTCAATACAATCACCATTCCTCTAACTCCATCTTCTAACCT
ps_bridge244	CACCACTTAATCCTAAACCATATTTCCTACATCACTCCTCCTCAAC
ps_bridge245	ATCCACAATCACTCATCCATCCTTTACAAATCCTTTCACATCCAAA
ps_bridge246	CAACTACCTATCCTACTCCTCAATACATACATCCACCAACTTCCTC
ps_bridge247	TCCAAACTCCTACAAACATTCCTCATCACAAATTCCATACTCCTCT
ps_bridge248	ACACATCCTCCAACTCACAACCATTACCAACTTCTTTCCACCACTA
ps_bridge249	CTCACCTCACTAACCTCAAACCATCTTCTTCCTAAATCAACTCAAT
ps_bridge250	CATTCAAACCAATCATCACTCCATTTCCACACACTCATATCATCTT
ps_bridge251	CCTTCTCTTAATCCAACCTTTCCACAAACCAAACAATCACACTTCT
ps_bridge252	TCCATTACCAACAAACCTCAACTTTCTTTCTCAACTACATTCACCA
ps_bridge253	TCCTTTATCCTCTCCTCTCAACTAATCCTCTACCAATCACAACTAT
ps_bridge254	TTTACACTACTCTTCAATTATCACAACCACTAACTCACCATCACCT
ps_bridge255	CTTTCCAATCACCTACTATCTCACCTACCATTAATCACACACACAA
ps_bridge256	TCATCAACTTCTTCCAACTACTTACCATCCTTACACCTCCTCAACC
ps_bridge257	TTTAACACCTTTCTTCATCCTATCTCCAAATTTCACCTCTCTCTCC
ps_bridge258	CCTCCATTCCTCTCCTAACACCTTCCTCACTCTCTACCTCTAAACT
ps_bridge259	CCACTACTCATAATCCTCTTCCTACCAACCTTATAACCTCCAAATC
ps_bridge260	CTCATAATACCTTCTCCAACATACATTCCTCTTCCATCCTCATTCA
ps_bridge261	ACCACCACACTACTCCAAATTTCCTCAAATCAACCATTCACTAATA
ps_bridge262	TCATTCAACTTCCAATCATTCCACCATCTCTACACCACAATACACT
ps_bridge263	AACTCCATCCACCTTTCTACACACAATCTATCCATTCAATCCTTTA
ps_bridge264	CCTCACACATCACCACATTCCTCTTAACATTCTACTCAACTCTCTT
ps_bridge265	CATCTAACTCATTACTCCACTCTTCTCACCACCTCATTCTACAATC
ps_bridge266	TTTACAAACATCTTAACCAACTCACCTTAACTCCTTTCCACTCCTC
ps_bridge267	CCACCATTCTACAACAATCACTCCTTAATACACTCCATTCTCAACA
ps_bridge268	ACTTTACTTACTACCATTACACCTCTACCTCCTCTCATTCCACAAC
ps_bridge269	ACCTAACCACATTCCACCACTTCAATCACTTTACCTAAATAACTCC
ps_bridge270	ACTCCACCAAACATCAATACAAATCCAACCAATACAACCATTTCCT
ps_bridge271	TACTACCACACTATTACAATCCTTCCACACCAATACTTCCACACCT
ps_bridge272	ACTTACACTTCCATTTAACCTCCTCTCTAATCACCATCATCTCCAT
ps_bridge273	ACTTTCACCTCATCACCACACATTTCATACCTCACATTATTCCTTA
ps_bridge274	CACCTTCCAACTATTCCTTCTCACCACCTTCTACATTTCCTTCAAA
ps_bridge275	CTCCTTACCTCCTCACTCTCACTTTACTCAATTTCCTTATTCCACA
ps_bridge276	TTTAACCTCCATACCTCCATCATCTCCACCATACACTACCATTCCA
ps_bridge277	TCCTTACACCAACTATCATATCTACCACCACTAATTCAACCAACAA
ps_bridge278	AAATCTATTACCACTCCACTCTCTAAATCTACAACACTCCTCTCCT
ps_bridge279	CTCCAATACACATTCTCCACCAAACAAACCACTTCTCCTTTCACCT
ps_bridge280	CCAATATCTCCACACATCCTCACCATTCCTACCACTATCTAATCTA
ps_bridge281	ACTAACACATCCACAATCCTCTATTCCATCCTCACATAAACAACAC
ps_bridge282	TCTCTTCACCAATCTTTCCTTTACACCATCACTCTACCACTACTCT
ps_bridge283	CTTCCTCATTCCTTTCACCACCACTTTAAATACTTCTACACCACTT
ps_bridge284	CACTCCAACCTATTTACCTACTACACACCTCCTAACCTCAATCTAA
ps_bridge285	CATCCACACACAACCTTACTATTCACACCAATCCTCTCAAACACTC
ps_bridge286	ATTTCTCCACCTTCCTCAACACATCAATTCTTACCACAACTCCTTT
ps_bridge287	ACTCCTCTTATCAACTATCTCTCAACTCCACCATCCTTCAACATAT
ps_bridge288	TTATCTACTCACCTTCCACATTCAAACTCCTAAACCATCACTCAAA
ps_bridge289	ACCACCACACATTTACTTCAAACCTCACTCTTTCCTACAATCTATT
ps_bridge290	CCTCCTTACCACTCAATAATCAAACTTACCTCTCACCTCTACACCT
ps_bridge291	TTAATTCACCTTCTCCTAATCCTTCTACTTCCACATCCTCCTCAAC
ps_bridge292	CTCCACCAAACTCCTTTCCTCAACAAATAATTCAATCCATTCTCAC
ps_bridge293	AACAATCCATTCTAATCACATCCTATCACCACTCAACTTCTTCACC
ps_bridge294	CCACTACCATATCTCACTACCACTCAACATAACCATCTCCTCTTCC
ps_bridge295	CCTTTACACAATATTCCACCACTAACAACCTTTCTTCACTCATCAC
ps_bridge296	TCATTTACTTAACCTTCCACCACTCACAACTTCCATTCTCAACTTT
ps_bridge297	AATTTACCACCTCACTTACATCATCTCATACCACACATCTTCCACA
ps_bridge298	CCTCATAAACACACTCAATCTCCAAACCATTCCTCTAAACCATCAT
ps_bridge299	TATCAACTCTCTCATTTAACACACTACAATTACACCTCACACCACT
ps_bridge300	CCATCCTCCACATCTCATCACTTTAAATACCTCAATCTCACTCTAC
ps_bridge301	TCACTCCTCCATACATCCACTCCTCCTCTTCAATATACCTACATCT
ps_bridge302	AACATCCTATTCTCTAACACCAAACCTCAACTCCAATCTCCTTTCA
ps_bridge303	CTCTCCTCTCTTCTCAACTATCTCAATTTCCACTTCAACTACTCCT
ps_bridge304	ACTCACTACATACTATTCCTTACTACCACATCTTTCTACCTCCTCC
ps_bridge305	TCACCTCTCAAACTTCTCTCACATCCTCAATACTATACCTACCACT
ps_bridge306	AACAACACAAACATCTTACCAACCTTCATCACATTCTTCTTTCTCC
ps_bridge307	CACCTCAATCACTTCTACTAATACTCCATCTTTCCTCCATACAACC
ps_bridge308	TTATATCCATACACTTCAACCACCTTCCAAACCTATATCATCCACC
ps_bridge309	AACCACATCATCCTTCATACTCCTCCAAACCAACTTCTCTTCCTTA
ps_bridge310	TCTACCTCAAATACTCATACTCTCCAACCTCCACTACCAATCATTC
ps_bridge311	TCATTCCACTCTTATTATCTCCATCTTTCTCCAACTCCAATTCACC
ps_bridge312	TCCACAACTCTACACATCATTCATCCACAACTACAACACAATCAAT
ps_bridge313	ACCACCTACAACAAACATACTAAACCAACTTACCTCTCATACCATC
ps_bridge314	CTACTCATTCCTAACCACACTCATACCTCTCTTTCCTACATCTTCT
ps_bridge315	ACCTCCAACAATCCATCCATCATCCTCTTTAACCATACATCCTCCA
ps_bridge316	ACCAACTAATCCATCAAATCACAATCACCTTCTACTCAACACTCCT
ps_bridge317	AACTCTCACATCCACACCAATAATAACTTTACATCATTTCACCACC
ps_bridge318	CCTAACAATCAACCATTCACCTAACACTATCCACCTCACAACATTA
ps_bridge319	CTTTCCAACACATTCCACCAAATCCAAACAATCTCCTATTCACAAT
ps_bridge320	AATCACCATTACACCTAATTCCTACTCACCATCCATATCACTCTCA
ps_bridge321	TAACATCATTCAACTCCAATCCTACCACCACTCTTCCTAATACACC
ps_bridge322	AACACACATCACAAACACCATTCATATCAACTCTATTCCTCCATCA
ps_bridge323	TTCACCACATACCAACTTCATCCAAACATAACTCCTTACAAACACC
ps_bridge324	TCTCCAACTTTACCTCTTCTTCACACCTCTCCTATTTCAATACTCA
ps_bridge325	AACATCCAAATAACATTATCTTTCCACACACCTTTCCTACACCTCA
ps_bridge326	ACTTCTCTACCTCTTAAATCCATAACTCACCATCCATCTTCCAACT
ps_bridge327	CTCACATACATTCTACCTCTTACCTCAATCCAACCATCAACAACCA
ps_bridge328	TAACACCTCACTACTAACACACCATATTCTCTCTTCACACAACCAA
ps_bridge329	ACCACTCCAATCAAATTCCATCATATCTCACACCATCCTAATTCCT
ps_bridge330	CTTCACAAACAATTACAACCTAACATCCACCTAACAACACCTCAAA
ps_bridge331	ATCCATCCAACTTCCATATCCATTAAACTCACCACCAATACACTTC
ps_bridge332	TAACTCATCTCTCACCATCACACACTTCATACCACTTCACTCTATT
ps_bridge333	AAACACCTCTCTCTTAATCTCCACTTTAACATCTTTCACATCTCCA
ps_bridge334	TTATTACAATCAACTTACACCTTCCATTTCCACTCAACACCTCTCC
ps_bridge335	AACACACCATCAACCTTCACATCTTACATCTAAACCTCCAAATCTT
ps_bridge336	TCTTACACACCTTAATTACAACACAATCAATCTTCCACTCTCACCT
ps_bridge337	TAACCTTCCTCCATATCAACTCTAAACCACATTTCCAATCACACTC
ps_bridge338	CTCTCCACAACCTTACTCTCCACCTTCAACACTTTAACCTTCTCTA
ps_bridge339	TCCACCTTCCATACACAACCAATAACACACACCTAACAAACTAATA
ps_bridge340	CATCTCTATATCTCAATCTACCTTCCATCACCTCCTCTATTCCTCC
ps_bridge341	CTCACTCACCACACTCTTACACCTAACACTCACAATACTCTTTACA
ps_bridge342	CTCACCAACCAATCCTTCACACATAAACACAACCTACACCTTATTT
ps_bridge343	TCACTTCTTTACTCAATCCACCTTTCCAATCTTACACCACTTTCTC
ps_bridge344	ACAACACTTCATCCATTCACCTTTCCTTCTAACCACAATACACACC
ps_bridge345	TTTACCATTCCTTTACTATCCTCCACATTTCCTCTTACACACCTTC
ps_bridge346	ATTCACACACCATCTAATTCATTACTTCCACACACTCCTTATCTCA
ps_bridge347	TACATCACCTCCACAAATCACACCAAACCAACTCTATCCATTTAAC
ps_bridge348	TCACATAACCTTTACCTCACTCATCACTCATCAACCAACCAACCAT
ps_bridge349	CATCAATACCTTACACTCCTTTACCTCATAACCTCCATTCCTCTCT
ps_bridge350	ATCCTACCACACTTTCCACACCTTAAACTACTCAACACTATTCCTA
ps_bridge351	ATAACCAACCTTTACTCACAACAATACTTCCATCCACAAACCTTCC
ps_bridge352	ACCACACCAATCCTCAATCCTCTCTCAACTACTATTTCCAACACCA
ps_bridge353	ATCATCTCTATCCTAAACCTCTAATCCAACCTTCTACCAACACACT
ps_bridge354	TCATCACACTCCTCCTACCTCCACCACAATTAAATCATACATTAAC
ps_bridge355	CTCTATTCTCACCTCTTCACTCTAATATCCACAACCACATACTCCT
ps_bridge356	CTACACAACCAATACTCACACCACTCACTACTTCCTATCTCACTTC
ps_bridge357	AAACCTACACCTTTCCTCTCCACATATCATAACTACCATACCAACA
ps_bridge358	ATTCTCCTATTTACCACCTCTAACAACCTTACCATCTATCTCCTCT
ps_bridge359	CCTACCACCAAATCTCCTCCTACTACTATCTACACTTTCTTTCCTT
ps_bridge360	TCTCACATACAATACACCATATCAAACCTATCAACACCTCAACCAT
ps_bridge361	ATTCATTTCCATCCACAACACTCATCATCTCATCATCTCTTCTTCC
ps_bridge362	ACTCTCCACTATCCAAATCTCATTCCTCATTACATCATTTCCACAA
ps_bridge363	ACTTCACAATCACCAATTAACATTCACTCCATCCTTTCCACAATAT
ps_bridge364	TCTCATCAACCTCACACTCTTCATCAACTCTAACCACTTAATCCTC
ps_bridge365	AACTTCAACTATATTTCCTCCTACCACTCCAATCCTATCCTCTTCT
ps_bridge366	ATTCCTTCATATACCACAATATCCTCCTAACTCCTTACCTCTTCCT
ps_bridge367	ATCTCACCATACTTTCACCACACTTAAATCCTTCTCTCACATCACA
ps_bridge368	CCACATCATTCCACTCAACACTCCTAACTCCTCTATAATAAACCAA
ps_bridge369	TACTCCTCCAATTTACAATCTCTACAACACCATTCAACCTCAATCT
ps_bridge370	TTACCTCCAATCTAACCTAAACTCTACTCCTCCACAACACCAATTT
ps_bridge371	CCAACCACATCCAATCATAATATCCACCTATTCTACCACCTCTCCT
ps_bridge372	ACCTTTCTACTCTTCCTCATCAAACTCCACACTACACATCCTAACC
ps_bridge373	CTTACTACCAATACAACCACCTAAACTTACTCCTCACCTCACATTC
ps_bridge374	CCAACATTACACCACCTTCATCTACATACACAAACTTCTCTCTCTT
ps_bridge375	CTCCATCACACTCCTCAATATCTCATCCTAATCCTTCACACATCAA
ps_bridge376	CACCTACATCCTATACAATCTCACCATCACTCCTAACCTATACCTC
ps_bridge377	TCCACCATCCTAAACCTACCTCATAATCAACTTATTCCACTTTACC
ps_bridge378	AACCTTTCCACACATTCCTACTTATATCTACCATCACTCACACCTA
ps_bridge379	CACTCTCCTAATACCTTACCTTCTATACACAACCTTCACCACAATT
ps_bridge380	CCACTCCACTTTCAATATCAATCAACTTCTCCTTATCTCTCCAACC
ps_bridge381	AACACAAATCACTCCTCCTTCCATCACAATCATATCACTAATCACC
ps_bridge382	ACCACTTTCATTCCTCATACCACTTCTCCTTATAACTCCTTCATCC
ps_bridge383	TCCATCTACCTTACCAATACCACTTCCATTCATATCTCACCACATA
ps_bridge384	ACCTTCTCACAATTCCTCACTTCTCCTTACTCATATCCATCTCTAC
ps_bridge385	TCCATCAATCACCATCTCCATCACACAATTTCTACACCTACTCACT
ps_bridge386	CTCTTTACAACCTCACTCCAACTTACTTCACTTACCACATTTCCAA
ps_bridge387	CAAATTCTTCCACAACTCCTTTCCATCAACAATACAACCATCACTA
ps_bridge388	ACCAACATACCTTCTCACACTCACACTCATAATCTCCTCTCATCCA
ps_bridge389	TCCTTAACCACCATTCCTTCCTCTTCATTCCTATCACTCCATAATA
ps_bridge390	CCACCTCCTCATTTATAATTCCTCTCTTCCTCAATCCTACACCAAC
ps_bridge391	ATCTCTCCTCTTCCACACTCTATCAACCACACACTATTTACCACTA
ps_bridge392	CCTCACTCATCTCCACAACAATACCAATTACACTATTCTACTTCCT
ps_bridge393	TCTACTACACAAACTTTCAAACACCTTCTACTACCACCTCAATTCC
ps_bridge394	TCCTCTACTTACCAACTACCTTTCAACAAATTCAAATCAACCACAC
ps_bridge395	TCCTACCTTCTTACAATTCACTACCATCCATTCACCATTCCATAAT
ps_bridge396	CCTTCCTACCTTCTTCTACAATACACCACAAACTTTAACAACCTCA
ps_bridge397	TTTACATTCTTCCACCTTAATACCAACATTCTCCTTACCAACACCA
ps_bridge398	CTACCTTAACACAAACCACCATAACACCAATATCACCTTCCTTACT
ps_bridge399	ACTTACACACCTACCACATACTCCTCATTCAACTTCCAACATACCA
ps_bridge400	TCCTTCCAACCACTATCAATTCCTTACCACTTATCCTCAAATACAC
ps_bridge401	CTTCCATCCTCCACCTCATCTATTACACTCAATCTTCTATTCCTCC
ps_bridge402	TTCCAACTTACCAATCCACCTTACACTTACTACCACTCTAACACTT
ps_bridge403	TCTCATAAACACCAACAACCATTACATTCTAATCCACCACCAAATC
ps_bridge404	ACTTACTTCCTACCTCATCCATTCCAATCCATACTACTTACTACCA
ps_bridge405	AACCTCTCCTCATTCCACACTTTAAATTTCTTCTAACCACTACCTC
ps_bridge406	ATCTATTCCTCAATTCACACCACTTCTTACATTTCTACTCACCACC
ps_bridge407	TACACAACTACCACTCCAAACCACTAATATCCACATACTCACCTAT
ps_bridge408	AAACACCTTTATCATTCCTCAACACAATCACTCCATCTCCACATAA
ps_bridge409	TCTCCACAATCATTACCAAACATATACACCACTACCACATCCTCTA
ps_bridge410	CTAATACACACTTAACTCATCCACTCTCACAACTCTCCATCCATAC
ps_bridge411	CAACAACCACCACAATCTTCTACCTACTAACTACCTTCCTTACCTT
ps_bridge412	AATAACAAATTATCACACAACCAACCACTTTCATCCTCACAACTCC
ps_bridge413	TTCCTACATAACCTCTCCTCTCACTCTAATCATCCTTACTCCTTCC
ps_bridge414	TCCTAAACTCTCATTCTCAATACCACCATTCCAAACTTCCACCTCC
ps_bridge415	CACCTACATCTCTCTCCTCCTTTCCTCGACACCTAACCATCTCTAA
ps_bridge416	CCTCTATCCACAACACCTCATAATCCAATTATACCACTCTCACAAT
ps_bridge417	TTTCCTAACACACAATTTCCAACTACCTCTAATCTCCACAACCAAT
ps_bridge418	AACTTATTCATCCTCCAATTCAACCTCTCTCCTAATCACCTCCTCC
ps_bridge419	CACAAACATCTAACCACACACTTCACACTTCAAACCTACTCTCAAA
ps_bridge420	ATTCTCACTCTTCTCAACCACACTCCATCTCTTCTCCTAAATCTAC
ps_bridge421	ACTTTACCTCACATTAACACTCACCTCTCTCTTCACTCCAATCTTT
ps_bridge422	CAAACCTTCTTCACATACCTCTTAACCTCATCCTTCTCATACTCAA
ps_bridge423	TTCTACCTCCACCTACTCCATAACTTACATCAACTTACTATCACCA
ps_bridge424	CTACATACATCATCCACCTAAACACATCACCACACTACTTACTCTC
ps_bridge425	TAAACCTTCCTCTTTCATACATCCTTCTATCCAAACCTCATCACAC
ps_bridge426	CCTAACCAATCCACTCAATACACTACCAATTTCATCTCAACCTCTA
ps_bridge427	TTACACACCAAACACTCTAACACTACTCAAATCTCTCTAACCACAA
ps_bridge428	ACACATCTCACCATCAATATCAACCTCAAACTCACAACTAATCCAA
ps_bridge429	TTACACCTTCTTCCATCACCACTCACACATACCAAACATCAAACAA
ps_bridge430	ATCAACATTCACAACTACCAACTTCTTCCTCTACTCCTTATCATCC
ps_bridge431	ACCACACCACACTATCCTAACACAACATCTCACTCACCATATCATT
ps_bridge432	CCAATAACCACAAACACTAATTCCTCACTTCTAACACCATTTCCTC
ps_bridge433	TACTATCTCCACTTCCTCCTCAACCTCCTAATCCAATCACTACTAC
ps_bridge434	TCATTCACAACCATTACCTTTAACATTTCACACTCTTTCCTCCTTC
ps_bridge435	AATCTCAACAAACCACAATTCTCTCCACTCCACACATACTCACACA
ps_bridge436	CCATCCTACATCCACATACTCTCACATCTTCAACATCTTCCATTTC
ps_bridge437	CCTCATCCTACATTCTCTCCAAACCATCTCACTCTAAACTTTCTTC
ps_bridge438	CAAATACCAATCTCCATCCTCTAACCATATACACCTTCACATCTCA
ps_bridge439	CCATCTCCTACCATTCCAATACACTCCATATTCCTCAAACCTCAAT
ps_bridge440	ACTATCACACAACTCCACTACATACATTCTCTACCAAACATCACAC
ps_bridge441	TCACTCACCAACTCTTACTACCTTTATCTAACCAATTTCCTCCTCC
ps_bridge442	TTTACTTAACACTACCAATCCATCACAACATCCACTCTCACCAACC
ps_bridge443	CCAACCTTCCATCTCTCCACATTAAACACTTCCTCCACTTTCTACT
ps_bridge444	TAACATCACTATCTACCAAACCAAACCAACATCTACACTTCACCTC
ps_bridge445	TATCTCTCTAAACTCCACTCAAACCTCCATACATACTCCAACACTA
ps_bridge446	AACTTACTCTACCATCCTACTTCACTACACCATTTAACCAATCACC
ps_bridge447	TCATTCCTAACTCAATACTCACCATCATACCTCCTCCAAACAACAT
ps_bridge448	CCACTTCTACCTATCCATTATCTTCCTTACTCCTCACACATCCTTC
ps_bridge449	CCAATTCTACACCTCATACTATCCAACCAATTCCTCCAATCACATT
ps_bridge450	CAACTACACCACTTCACACAATCACCTCTCATTCACTAATACCTCA
ps_bridge451	CTCAAATTCTCCACCTCTATCACTCATCCTCATAACCAATCCATCC
ps_bridge452	TACCATACCTTTCCTACACTCCTATCTTCACATCACCAAACTCTAT
ps_bridge453	CCTCCTCATATCCAATCCTCCTCTCATTTCTACATAATCACTCACC
ps_bridge454	CTCACTAATTATCTCACTCAAACCTTACAACTCCTACCTCTCCTCT
ps_bridge455	TTTACTCCTTTCATCATTCTCCTCCAACCTTCACAACTTCAACACA
ps_bridge456	CACTCCTCAAATACAACTCATACACCAACACTCCTTACACACACTA
ps_bridge457	CCTATCATCCATCTCTAAATCCACTCCTTTACACCATCTACCACCA
ps_bridge458	CTAACACCACTTCCATTACATTACTCAATCACCTCTCTATCCTCCA
ps_bridge459	ACCTCTATTTCACCTCAATCCTCAATCAACTCCAATACAACTACCT
ps_bridge460	TCACAACCACACCATACCTCCTACCTCATATTCAATTTATCTCAAT
ps_bridge461	TTTCATTACTTTCCACCTACCAACCAAACCACTACCATCTCTCTTC
ps_bridge462	ATCTACCTCCACTCTTCTCAACATCCTCCTTAATCCTTCTTCCACT
ps_bridge463	TCCTCCTTTCATAAACCATTATTCAACATTACCTCCACCTCCACAC
ps_bridge464	TTTAACTCACCACATCTACTCAATACACATCAACTCCACAAACCTC
ps_bridge465	AACCACTCTCTTCACTCCTAATTACTTACATCACCTTCCATTTACC
ps_bridge466	ACCTACATCCTATAACTCCTTCTATCCACTCCTACCATTACCATCC
ps_bridge467	ATCAACACTACTCATCAAACACACTCCACACACTCTTAACACTTAC
ps_bridge468	CCTCACATACACACATCATAACACACTTCATCCTTTCCTCCTTCAC
ps_bridge469	CCTCCACATCTTCTCCTTCATAACATCTTAATTTCACCTACACACA
ps_bridge470	TTCCTCCTTCACATTACTACCATCCTTAATCTCCACACCACACAAC
ps_bridge471	CAATCACTTATCACACAACCAACTTTCCTCCAATTTCACCAACTAC
ps_bridge472	CCACTTCTTCATCCAACCAACTACTTATCACACCACTCTCTCAATT
ps_bridge473	ACCTTACATATCACCTCAACCTCTACCTAATATCTCTTCCACTTCC
ps_bridge474	CAATCCACCTATCTAACATCCACTCATTACCACAATAACCACCTCT
ps_bridge475	ACCTCCAACCATTTCTATCCAAACCAATCTCATATCATACCAACCT
ps_bridge476	CACACACCTAACACTTCTCACTACACTAATATCACATCCATCAACC
ps_bridge477	CACACTCATCCTTTACACACACCATCTTATACTTCTCCATTCCACC
ps_bridge478	CCTTTCCAAACCACACTCCAACACACTCAATTCTATTAATAACCTT
ps_bridge479	ATACTCCACTAATACTCAACTTCTCCTCCACCATTCTCTAATCTCC
ps_bridge480	TCTCATACATTCCACCTAACCTCACTCTCAACAACTAACACTCCAT
ps_bridge481	AACTTCACCATTCACCAATCCTCTATCCTCACATCACATCTTACAA
ps_bridge482	CAAACCACAAACTACACCACTACTCAACTTTCATACTTCACACAAT
ps_bridge483	CCATCTACTTAACCTATCACCAACTCCACATAATCCTTTCCTCACT
ps_bridge484	TCACCTCATCTACTCTAAACATCTTCTCCTCATTCCAACAATTCTC
ps_bridge485	CCAATAACTCACACCATCTCCATCACTATCCACAATCTCTCTTCAA
ps_bridge486	CCACCATCTCTCTAACCTTTCCTCACTCACTTTACACATACCTTCC
ps_bridge487	TCAATAAATCCAATTCCTCTCTTCACCATCTAAACCACACTATCCA
ps_bridge488	CAACCATTTCCTAATCCACTTCACTTCATCACAACTTCCTAACAAC
ps_bridge489	ACACTCTTTCCTCACCTCAATATAATTAACCACACACCTACATCAT
ps_bridge490	CCACACTCAACAAACTCATCCTTATCACTACTACCTTTATCACTCC
ps_bridge491	ACTTCCACCTCTACTTTATTTCACTTCCTCCTCTAAACTCTACTCT
ps_bridge492	AACCACTATTCAACATCACATAAATACCTCTCCACACACTCCACTT
ps_bridge493	TCCACTCTTACACTACAACACCTTAATATCTACCATCACTTCCACT
ps_bridge494	TATCTTTCAATCCTTCACCTTCAAACTCCATTACCTTCTCTCCATT
ps_bridge495	CACCTATACTCCTCCATACCATACACCACACTCCAATCCATATCAC
ps_bridge496	CACCATCAATCCTCCACCAACTCAATCTATTATCCACACCTTATTA
ps_bridge497	TACCATCTATCAATCCTAAATTCACCAACTCCTCTCCTTAAACCAC
ps_bridge498	ATCCAACCTTCATTCTTTCACACCAATACACTAACACATCCACTTC
ps_bridge499	TCTTTCATCTCAACCTATCACAACCTCTTCCAACTTCTCACTAACT
ps_bridge500	TTACTCAACTCTTCATCAACTAAACATCACCACACTCTCTACTCAC
ps_bridge501	TCCATCACTCCAAACTCTCAACTCACAATACTTAATAACCTCCATC
ps_bridge502	TCATTCATTTCTACTCCACAATTTCCAATACTCCATTCCACACACT
ps_bridge503	ACAACCAACTATCCACTCAATACATCCATTTCTCACTCTCTTTCCA
ps_bridge504	ATCACAACACCTTCAAACTACACTTCCTACCTTACATTCACCAAAC
ps_bridge505	CTCCACCTTAATCCATACATCCAATTCCACTACTCTCTACCAAACC
ps_bridge506	TCCACAACACAACCATTTCACTCCACATCAAATATCCTACTTATCA
ps_bridge507	CACACCACACAAACATCCAACTTTACCTAACCTTCCATTACCATCC
ps_bridge508	TACTCTTATTCCACCACTACTCATAACCAAACCACACCAAATTCCT
ps_bridge509	AACTTACTCCTCCTTCCAACCAATATCTCCATCACCACACTACTAA
ps_bridge510	TTTCATCTCAACCAAATTTCCTTTCACACATTCCACTAAACCAACA
ps_bridge511	AAATTCCACATCTCCTACTCACTTATTACTCCAAACTTAACCACCT
ps_bridge512	AAACTAACTTCCATATCCTTTCCACTCAAACTCTCCTACACCACCA
ps_bridge513	CCACATCTCCACAATTACCTTTCCTTCTCATACTTTCCTTCCATAT
ps_bridge514	ACTTAACTCTCAACATACTCCACCTCCAACAAACAACTCATCCTCC
ps_bridge515	CAATCCTACTACTAAACCTACCTCCTCATCTCACACACTTTCTCTT
ps_bridge516	TTCCTTTCACACCATTTCAACCACAACTCTCAACCTACTCCACATT
ps_bridge517	TCACCATACTCCTTTCATCTTTCACTCCAACATTCACAACTAACAC
ps_bridge518	ACTACATCACCATTCTTTCAATCCATACTCTCTCCACTCACTAAAC
ps_bridge519	CCAACTTCCACATCCTAACCTCTTCAACTCCTACATCTAAACATAA
ps_bridge520	CACACCATTCTATAATCCTACACTCACCTTAATCATCCTCCTCACT
ps_bridge521	AAATCCTCTACCTCTTACTCCACACTCACCTCCATAAATTTCTCAA
ps_bridge522	ACCACTCTCATTTCCTCAACCTCCACCTATCTCTTATTTCTAACTC
ps_bridge523	CACAACTTCTTCAAACTACACTACTCTCACAACCATCATTCTCCTC
ps_bridge524	CACCTCTTCCATACTTCCACAAATTCACCTTCTTCTTCACCTTTAC
ps_bridge525	CAACCTTCCAAATCTTTCCATTCTTCATCCACACCTCTACACTCTT
ps_bridge526	CCTTCCACCACACTCTTTACATCATAACCTTACTACTACCTCCAAT
ps_bridge527	ACATCTCCAACTACCTTTCCACATAAACTCCAACTACCAACCTTAC
ps_bridge528	TCTCCAAACAATCACACATCAACCACCTAAACCTAAATTACATCCA
ps_bridge529	CCTTTCAACACTATTACTCTTCTCCTTCCTACCTCTCCTTCCTTTA
ps_bridge530	ATCCTCATCCTAACTCTCACCTTATCCATCCTCTTTAACCACAATC
ps_bridge531	TCTTATATCCACCTAATCCATAAACACCTCTACCAACTCACCACTA
ps_bridge532	TTTACACACTTCTTATCAACTCTTCCACATCCTCAAACCTTCACTA
ps_bridge533	ATCCACCAACTCACCATCATCATACCATCCTTAATCACTATCTTAC
ps_bridge534	AACCACCAATCCTAAATCCACCAAACCTTCATTCCACAATTCTTAC
ps_bridge535	AAACCTACTCCATTCTTTCCAATCCTTAACCTCCTACACCAACTCC
ps_bridge536	CTTCTTCCATCCAAATACCATAAACCTCTCCTATACACACCACATA
ps_bridge537	TCTAAATCATTCTAACACTACACCACCTACCAATTCCTACCAACCT
ps_bridge538	ATTATCCAATTTATTCTCCTTCCACTTCTCACTTACACCTCCAACC
ps_bridge539	ATATCTCTTATACTAATCCATCACTCCTCCAATCACACCTCTTCCA
ps_bridge540	CACACATACATACCTACTTCTACACACTTCTATTCACCAACACACT
ps_bridge541	CTCTTATCATCCAACACATACTCTTATACCTCACCTTCCTACCACT
ps_bridge542	TACCAAATCTTTCCTCCTCTCACTACTATCACCTCAACAATACCAC
ps_bridge543	CTACTATCCTCCATCTAACACCATTTCTTCCAACATAACTTCACCT
ps_bridge544	ACATCACTCTCCTACTCTCTCCAAACTACCTTACAAACCAAACAAC
ps_bridge545	CATTTAACCTAAATCACCATCACATACTCCACATACCACCTTTCAC
ps_bridge546	ACCAACACACATACTTCCTCACATCTTAACATACACACAATTCACA
ps_bridge547	CTCACCTTAATTCAACCTACTCACCTCTTCACACTTAACACTTCTT
ps_bridge548	ACACTCAAACTACCTCCTTCACTACATACTCCAACAATCTTAAACA
ps_bridge549	TACTATCATCAACCTACAACTTTACCTACACCTACCATCACTCCAA
ps_bridge550	AATCTCCATCTACCACCACATCTTCATATTTCACTTCATTCCTACC
ps_bridge551	ACAAACCTTCCTTCATCACAAACCTTAAATTCTCTTACTCTCACCT
ps_bridge552	CTCCTTTCCACCAACTCAATTATTACTTCACTTTCTCAACACATCC
ps_bridge553	TCACTACCAATCAAACACTACCATTCCACAACAATCCTCTCTAACC
ps_bridge554	TCCATCCTTCATCCTCAACACCACACAATCATTCATTTCCATTAAC
ps_bridge555	CCTCTTCCACATCCAACCTATCACCAATCTCATTCTCACAATATCT
ps_bridge556	CTCACCATCCTACTTCTCACCTACACTTCAATCCTTTCACTCTTAT
ps_bridge557	TCCATCACCAATCACAAACTCCACTCACACTTCTCATCATCTCTAT
ps_bridge558	CTAACCTATCATTTAACCAATCTCCTTCCTCCTATACCACTCACCT
ps_bridge559	TACTTACCTACCATCACCTACACAATACTCACTACACACCTCTCCA
ps_bridge560	TACACCTCTCACCACTAACACAATACAATCTCTTACATCACTCTCA
ps_bridge561	ACTCAACTACACTTCACCATCTCCACTAATCTTCCATCCTTATCAA
ps_bridge562	TTCACTCTTCTAAACCACTATCAACTTTCTTTCACCACTCCATTCA
ps_bridge563	AATTCATAATCACATCACAACTATCCTCAACCACCTTCATCAACCT
ps_bridge564	CTTCTCTTCACTTACACAACCAACTCTCTTCTACATCACCATCCAT
ps_bridge565	CTCTCACACTTCATTCCTAACACTATCACACCAACTACCATACCAC
ps_bridge566	CCTATCACTCACTACTCACACACCTCTTAATTCCACAACTTTCTAA
ps_bridge567	TCCTTCCATCCAAACCTTCACATTTCAACACCATCAACACTCATTA
ps_bridge568	TAACCAACCAATCTTACTCCTTAATTCACCACAAATCACTCCTTCA
ps_bridge569	CACCTCCAACACTCTCTTAACACACAAATCCATTATCCTACAACCA
ps_bridge570	CTACCAATTACTAATCAACAATCAACCACCTTTACTCCAACCACAC
ps_bridge571	AACCAATCTCTCTAATTCAACCTCTCCACTTAATCAACCATTCCAA
ps_bridge572	CTACACCATACACCAACATCACAACCACAACATTCCTCTTTACCTA
ps_bridge573	ACATCAACCACTAATCACCTACATAATCTACCTCTTCCATACACCA
ps_bridge574	CCACACATCAAATCCACCACATCACAATACCTCTCTATCATAACAA
ps_bridge575	CACAAACACATATTCCACTTTCAATAACAACTCTCACTCTACCACC
ps_bridge576	TCCACCAACTTACCTACCTCCTACTTACCTTAACTTACACCTCATT
ps_bridge577	TCCACTTATTCTATCTTTCAACACCATCCTCACTAACACCTCTACT
ps_bridge578	ATTACCTTAAACATCCTCACAACCTTCTCTCACCACAATCACTACC
ps_bridge579	CCAAACTCTCAAATCACAATTTCACCACCACTACACTTATACAACC
ps_bridge580	TAACTCCAATATCACACCACTTAAACTAACCATAACAACCACTCCA
ps_bridge581	ACCTATCAACCTTTCATCCACTTCTTCAATACACTCTTCACACCAT
ps_bridge582	TTCATCCTAACTCACATTTACAATCAACCTTCACTTCACCTCTTCA
ps_bridge583	CCTAATCTTCCACAATTCCTCTACTCAACAACTATCCATCCTCCTC
ps_bridge584	TTACCACTCTTTCTTACCATTCCTCCAACACCAAACCTACTACATC
ps_bridge585	ACATATCATATTCCACTCCTCTCCAATTATCCTCCATCTCCACCTT
ps_bridge586	CCTCTCCACCACAATAACTAATCCTACATCCTCACTACTTCTCCAT
ps_bridge587	TCTAATCTTCTCATACTCACACCATAACCTCCTCCACCTAATCTCC
ps_bridge588	TACTCCAATCCATAACCACCTTACCTACACCTAAATCCTAAACAAC
ps_bridge589	ACCTCAAATTACTTACATTCCAATTCACACCTACCTCTCCACTACT
ps_bridge590	CCTCACATAAACACTCCTCACCTTTATATCCTCACACATCTCAATC
ps_bridge591	CTATTCCACTTATACCACCAACCAATCTTCTCATACCACCAACTCT
ps_bridge592	ACAACTCTTCACACCTATACACCTCACTTCCTTTACCATTTACCAA
ps_bridge593	TACTTCTCCACAATTCTCTACCAAACCTTAACATACACACCTCCTA
ps_bridge594	TCTCTAAATCCAACTCACCTATTCACCTACCAACTACACTATCACC
ps_bridge595	CTCATCTTAACTACACATCTCTCACCTCTCTCATCATTCCATTCAC
ps_bridge596	CTCCTCACTTCCACTATCATAACTTTCCTCACTCTCTCCTATCATA
ps_bridge597	ACTCAAATCACACACCACAATTCCTTCTCCATCATTCACTCATCAA
ps_bridge598	ATTCCACAACACATCCACATATCACCATCTACATCTATTTCTCCAC
ps_bridge599	CTCATACCTCACCATTCCTACTATCCTAATTCCACCATTCAACCAT
ps_bridge600	CCATACTTCCACACAATCCATCCTATAACCTTCCTAACCTTAACCT
ps_bridge601	CTTATTCTCCACTTCTTACTCCTACAACCACCAATCAACTACCTAC
ps_bridge602	CCAACCAACAACACATCCACACTTTCCACTAAATACAACACTAATC
ps_bridge603	ACAATCTTCCTACATTACCTTACCACACTCTCTACCAATCCTACCA
ps_bridge604	ACCTCACTCTACCACATCACAATCTTCCATAACCACCAAATATAAT
ps_bridge605	ATTCCATCTAACACAATCACTAACTCAACACCTTTCTCCTCCTTCA
ps_bridge606	CTTCTCCTCTTAACTCATAACCAATTCACACTTCATCACAACCAAC
ps_bridge607	TATCTCCAAACTCATCCATCTCTTCCAAATCACCTATTCCATTCCT
ps_bridge608	CACTCCACATACTTCACCTCAACAATAAATACCACTTCACACTTCA
ps_bridge609	ACTTACACATCAACACAACCTTACTCATCCACATTAAACCTTCTCT
ps_bridge610	TACCTAACTCCATCCACTACCTACTAAACACCATACTCCATACTTT
ps_bridge611	ACTCTACAATCCAACAATCCACTTAACACCATCTCCTTTATACACA
ps_bridge612	CCTAAACCATCTACTACCAACAATACCTATAACCATCAACCACACC
ps_bridge613	ACCTATTCCTTCAACTCCTCTACAACACCACATTTAACTACTTCAA
ps_bridge614	TTCTTCTCCATATTCATCCTACCAATCCTCCATCTACCACACATTC
ps_bridge615	TCATCACCATCACCTTCCTTCAAACTATTCACAACAACTAAACAAC
ps_bridge616	TTCCTACCTTACATTAACCACCTTCCTTAAACACTCCTCTTATTCC
ps_bridge617	AAACATCCACATCCAATACACTTCCTTCCACATATCTACATACCAC
ps_bridge618	ACCTCACATCATATACCATTCACACATCACACCACATTACTACTTT
ps_bridge619	TTTACACTCCACATCTTCCATACCTACTCTCTTCACCATTCTCACA
ps_bridge620	TCATTTCAACTACTACTCCTTCACACTCCTCTACCATTCAATTCCT
ps_bridge621	CATCACTAAATACCACCTCACACCATTATCCTCACATATACCACAA
ps_bridge622	CTCACTCATCCACTTACCTCACTTCATACCTATCTCAACACTTTCT
ps_bridge623	CCAACTCACAACAAATCCTAATTATACTTCACCTCCACTCTCCTTA
ps_bridge624	ACACACACAACCTTCAACCTACTCATTCCTCAATCCTACAACAACC
ps_bridge625	CACTACCTCTTCACACTCTAATCCACATCTTACCTCTCCTTCACAT
ps_bridge626	ACAATACTCACTCTCCAATTTCTCCTCTCACCAAACTTCAACATCC
ps_bridge627	CTCACATCCATCCTCTCATCTACATCCAATTCCATCTCTCTTTACA
ps_bridge628	ACCTATTCCTCACCTCATCTTCTCTTTATCCACTCCTTATCTACTC
ps_bridge629	ATAACCAACTAATATCCACTTTCTTCCACCTCACTCAACTCCACAC
ps_bridge630	AACCACTCACAATACAAACACAAATACCTCTAAACCATCTTCCATC
ps_bridge631	TCCACATCACCATACACCTCAATTCTCCTACAATCTATTACCAATC
ps_bridge632	CCTCCACTATCCATTCACATACCTTCAATCAACCTATCAACACTTC
ps_bridge633	ACACCTTACTCTTAACTACTACCTTATCTACACCTCCACTTCCACT
ps_bridge634	TCATCCTCTTCTTATCCTCTCACATACACAACAACTTTCCTCTCTC
ps_bridge635	TTCACAACTTACATTTCAAACCAACCAACCATTTCCAATCCATCAT
ps_bridge636	AAACTTTACCATCCACTCCACCTTACTCATTTCTCTCCACACATCC
ps_bridge637	TCACTCACCAAACTTCACTCCTTTCACATACACACTTCCATCATTA
ps_bridge638	ACTTACCTATTTCACCTTTCCTCAAATTTCACACCTCCACAATTCA
ps_bridge639	TCCATTCACAAACATACCACACAACTCTATTCCACCAATCAATCAC
ps_bridge640	AAACTCAATAAACCATTACACCTCTTCCACACTAATCACCTCCATC
ps_bridge641	AACACACACTATACACTCTCTACCATCCTCACACCTCTATAATCTC
ps_bridge642	CCAACATCTTCTACTCTCACCACTCCAACCATTACCTTCTCCTCTT
ps_bridge643	ACTCCTATCAAATCCACATTCACTATCTTTCTTCAAACACCACCAC
ps_bridge644	CCACATTCACTCAACTATCATTTATTACAACTTCCTCCTCCTCTCA
ps_bridge645	CCACTCATCTAACTTCCTCTCACCTTCAATTCATATCATCTCCTCA
ps_bridge646	AACATCTACCTACCAAACACTAACACTCCACTACACTCCTCATCAA
ps_bridge647	ATCCTCCACACTACACTAACTAACCATTTACATCCACCTTACTCTC
ps_bridge648	CATCACTAACCATACAAACATTCTCCACTCATCTCTCTTACACCTT
ps_bridge649	CTTTCTATATTCAATCTCCAACCACTCACCAATCACTCTCTTCTCA
ps_bridge650	CTACCAACCTACAAATCCTCAATTCCACTCCACATTTCTCACACTA
ps_bridge651	CCTCTATCCAAATCCTACATAACCTCAACTCTCACTACACACTCAA
ps_bridge652	AACCACTCAAACTCTTTCTACCTTCTTCAAACCACAATTCTACACC
ps_bridge653	ACCTAACTACTTCATCTCTATCCATACAATCATCCACACTCCATCT
ps_bridge654	ACACACTTCCTCAATCCTTATCCTACCACTCATCCAATTATCCTTT
ps_bridge655	TTCCACCTATTCAACCACAATTACCAATTACAACCACCAACCATTT
ps_bridge656	CTCATCTCTCCTCACTCCATACCTTTCCTCAATACCACAATTATTT
ps_bridge657	CTAACCTCCTACCATACATACACTCATCTCCTAATATCCTCACCTC
ps_bridge658	AACACAACATTCATACCTCACCACTTCTTAACATCACACATACACT
ps_bridge659	ACTCTCACTCCATTCCTCTCTTCTTACACTCTCAAACTCACTTCTT
ps_bridge660	TAACATCTCCTTCACAACATCAATCAATACACCTCACACTAACCTC
ps_bridge661	ATCACACTTCACCTCCTAACAAACCACCATATTCCTCATTATAACA
ps_bridge662	CCACACTACACCAACCTCTTACAACAAACCTATCTACTCTTACATT
ps_bridge663	TACATCTACCAACACACACCACAATCCATACCTTAACACTCACTAT
ps_bridge664	CTCTCTACCACAAACAACACTTCCTATCAACACCAATACAACACAA
ps_bridge665	CAATTCATCATACTCACTTCTCTACTCTTCAAATCCATCCTCACCT
ps_bridge666	TACCACTCCATTTCCTCCACTCACAATCCTAAACACACTTACTACT
ps_bridge667	CACATCCATACTCAATCAAACACAAATATTCTCCAAACTCTCCTCC
ps_bridge668	CTCTACCAATTTACCACTTACATTATCCACCAATCCTTCCAACACA
ps_bridge669	CTTCCTCATCCTACCTCATATTCTTCACTCCTCCTCCTATTTCAAC
ps_bridge670	TCCACTCTCACATACTCACCTTAATTACAACACCTTCCATTCTCCA
ps_bridge671	TCACTACTTCCTTACACATTAAACAACCATCTTACTTCACACACCT
ps_bridge672	CACATATCAACATCTCTTCATATTACTCTCCATACCACCTCCATCC
ps_bridge673	CTCACTACACCAACAACAATCCAATTCCTTTCACATCTCTTCACAT
ps_bridge674	ATCACTCACCAAACCAACAAATACCTTTCATACCACATTCCTCCAT
ps_bridge675	CCACTACACTAATACATTTATCCTCTCTCCTCTCTACAACCTCACT
ps_bridge676	AACTCTCATACACTTCAACTAACCATCCACTTTACATCCATCATCC
ps_bridge677	TCTTCTCACTTCAATTCACATTCTCCATACACTCTTACTCCATTCC
ps_bridge678	CACCATCTAACATAACATAACCTTTCACACTCTCATCCTCCTCCAA
ps_bridge679	CACACCTTAAATTCACATCAACACTCTCCAACTTCTTCTTCAACCT
ps_bridge680	TCACAAACTCCATTCTACACAAACCAATTACATCACACCTACTCTC
ps_bridge681	CACACTACTCTACCACACTTTCCACCATTAAACAATCTCTTACTCC
ps_bridge682	TACTCTTCCTTCCACTTCTCATACAAACACACCTTCAATTTCCACA
ps_bridge683	ACTCCTCCATCACCTTATCACATCACACTCTTATCCACTCTCTCTT
ps_bridge684	ACCTCTTTCCAACACTCTCTTCCTTACATACTTCACTTCTAACCAA
ps_bridge685	CATCCACCTCAATTACCTAAACTCATTCTCTCACATTCTTCCTTCA
ps_bridge686	CCACTAAACTACACTTCCTTAACTCACATTCCACATCACTTTCCTC
ps_bridge687	TCATCTCATCTCTCACAACTAACCTCTCTCAACCAATCTACTCTTA
ps_bridge688	CCACACTCCTACCTTTCATCCATTCACCATTAACCTCATCAAATAT
ps_bridge689	TCTCAACCACTTCACCTACAAACTAAACTAACCATCCAATCCTAAC
ps_bridge690	TCACACCATTCTTATTTCCTTCCTACTCACCACTACCTCTTCACTT
ps_bridge691	TTCTCCTACTCCATTCTACCACCACCTATTCACTCTACACATCAAT
ps_bridge692	ACACCATTTCACATAACTCACTACTCTCCATTCAATAACATCCACA
ps_bridge693	CCAACCATCAAACCACTAATCAACACTCTCCTCACTATCATTCTCT
ps_bridge694	CCAATCTATTCAACCTACACATTCACTCAACCTTTCAAACTCCATT
ps_bridge695	CATTTCAATCACTTCACACCTTTCCATCCAACCACAACATCAAACC
ps_bridge696	ACCATCACTCCATTCCTCCTTACTCACTCTAACATCAATTCTTCTC
ps_bridge697	TCACCTTCCATATATCTCCATTTCTAATTCTCAACCACTTACCACC
ps_bridge698	CACCTATTCCACAAACCAATACATTATCCACTTTACTTCCAACCAA
ps_bridge699	CAACAAACTCCTTTCTTCCTCCATCCTACTTATCTAACTCCTCAAA
ps_bridge700	AATCTCCAACCACATATCCTAAATCACCTTCACCACAACAATCTTA
ps_bridge701	CCAATTACTCTCCAAACACTACCAAACTCTACTCCTCAAACAAACC
ps_bridge702	TCATACTCCTTATTCTTTCACCTCCTACACTCAATCCACATCCTTT
ps_bridge703	CACCACAAATTTCATCCAATTTACCTCACCAATCAACACTTCTTCC
ps_bridge704	CCACTTTCGATACTTAACTCCTCAAACATCCTCTCTACTTCTCCTT
ps_bridge705	TTTCACTACATCCATCCTACATAACCTATCCAAACACCAACATCTC
ps_bridge706	ACAACTCTTCTTCAATACCAATCTCTCCTTACATCACAACCTCACC
ps_bridge707	ACTCCATCTCTACTCACAACTCATCACTATACCAACCTCTCTCTCC
ps_bridge708	TTCCACATCTCCATATACACCAAATCTCACTATTTCCTCCTACCTA
ps_bridge709	TCTCTAACTCTTACCAAACTTCACTACAATCACCAACTCCTCACAA
ps_bridge710	CATCCACCTCAATTAATTTCCACACCTCTCATTAACCTTCTACACA
ps_bridge711	TACACTACTCCATCCTACACACCTTCAACCAACTAATACTTCATCA
ps_bridge712	TCACCTCAATATCCAACACTATCTTACCTACCACACTCACTTTCAT
ps_bridge713	CAAACATTTATCCTCTTAACACTCCACCTACTCACAACCTACCACC
ps_bridge714	ATCTTCTACAAACATCTCAAACTACTTCTCTTCCTCATCTCACCAC
ps_bridge715	ACCACCTAACTCTTTCCTTTCTCCTACCATACCATCCAAATCCACA
ps_bridge716	ATAACAAATCTAAACTCACAACCTTCCTACACCAACCTTACCACCT
ps_bridge717	CCTCATATCTACTAATCCACTTTCTCCTAATCACCACCAACTCACA
ps_bridge718	TCTACAACCTCATCTACACTACTATACTCTCCTCTATCCACACACC
ps_bridge719	CAACTCCTTTCTCTCTCAACACACACCAAATTACTACACCTTCAAA
ps_bridge720	CACACCATTCTCCTATTCCAAACAATACATCATTTCCACCAACATT
ps_bridge721	TCTCATCCTCACATCACACCTCTATCCATTATCAACCACTCTTTAT
ps_bridge722	ACCATAACTCCTTACCAACAATATCCAACCTTTCCATCACTTACAA
ps_bridge723	CACTCATTATTTCACAACACCTTAAACCTCTTCTCACCTCTCTTCC
ps_bridge724	ATTCCATCTCCAACCATTACTTACATACACCATCACTCCAACACTT
ps_bridge725	CAACACCAAACTTTCTCACATATCTATATCCTCCTTTCTCCTTCCA
ps_bridge726	CTTCACATATTACACTACATCCTCCACAATCCTCCACCACAAACTA
ps_bridge727	CACTCCATTCACCAAACAACTATAACACTTTCCTACTTCTTCCACT
ps_bridge728	CACACTCCAATACACTACTAACCACAACTTCTACCTAACATCCAAA
ps_bridge729	TCCATCCTCCTCTCTTACCTTATTTACACAAACTCAACTTACCTCC
ps_bridge730	ACCTTTCCTCACACTACTCAATAACCAACCTCTAACTACACCTAAC
ps_bridge731	AATCCTCACCACTCAATTCCAAACTCACACACACCATTCAATCTAC
ps_bridge732	ACACATTCCAACAACATAAACTCACTCTCTACTTTCCTCCTTTCCT
ps_bridge733	TAACCTTACTCCTCCTAAACTACCAAATCAATCTCCACTCCTACCA
ps_bridge734	AACCTACCTATACAACACCAACTCTTTCTTCCTCAACTCATCCACT
ps_bridge735	ATTTCCATAACCTCCAATCTCCACATACTCAAATCATCCTTCTTCT
ps_bridge736	ACCACCTTTCTCTCATAATTCCAACTTACTCCACAACACTCATTAC
ps_bridge737	TACCATTCACACCTACATCACTCTTTCCATTTCCTTCAACTATTCA
ps_bridge738	CACACCTACACTTTCCTTCTCTAACATATCTATCACCACACATCAC
ps_bridge739	TCTCCAACCTTTAATCCATTCAATTCATCCACTACCACCTACTACA
ps_bridge740	TCCTCACCTTAACTCACTCCTCCAATCATTCCATCATCAACAAATA
ps_bridge741	CCACATACCTTCTTTCTTATCATCTTCTCAAACACACCTCTACTCC
ps_bridge742	CATAAACTCCTCAATCCTACATTCCACAAACTTTCTCCATCACCAA
ps_bridge743	CTCTTACTCCACTACTCCACCTCACACAACTCATTTATTACAACTT
ps_bridge744	TCATAACAATCCACACCATTCTCTCTCCAACTTTCACCATTTATCT
ps_bridge745	CCTTCCACACCATCTCTCCTCACTATAACTATTTAACCACAATCTC
ps_bridge746	TCCAAACACCATCCTCTATCATTCCAATCTTTCCTACATACCTCTA
ps_bridge747	CCTACCAATAAACTCCTCCTTTCCTCACTCTCATCCACATACATCA
ps_bridge748	CTTCACCATAACCTCTAAACCTCATTCCAACCATTCCTACATTCCA
ps_bridge749	ACATCACTTTACATACCACACCTTCATACCTTCTCTCTACAACCTC
ps_bridge750	TAACCTTTCATACCTAATCATCCACCTACCTTACTACACCTCTTCT
ps_bridge751	CACTAACCAATTCCTTCCACAATCTCCACCTTCATCTTTCTAATCC
ps_bridge752	CTTCACTCACTCATCCTTTACCACTTCTCACCATCTTATCCTAACC
ps_bridge753	ATCTCATACCAAATCTCACACTCTCTCACTCTTACACACTCCTACC
ps_bridge754	CCATTCCTCACCATCATACACACTAACTCCATTCATCACTCTCCTT
ps_bridge755	ATTACACTATACACTTCCATCTCCTCACATACATAACACAACCACC
ps_bridge756	ACCAATATTCCACTTCACTCAATTCTCTACCTATCCAACCACAAAT
ps_bridge757	CTTTCTATTCACTCCTATCTAACCAACCTTCCTATTCCACACCATC
ps_bridge758	AACCACAAATCTAATCTTCTATTCCACATCCATAAACTCTCCACCT
ps_bridge759	TCCACTCATAACCTACCACAATACCTTACATCCACATATTCTACCT
ps_bridge760	AACCTTCCTTTCTATCCTTCCAATCCTCAAACACTAACCTAAATCC
ps_bridge761	TACTACATTTCCTAACACACAATACCAACTACTTTCCACCAACCAA
ps_bridge762	ACATCACATCTCTCCTTACAACCATAACCTCCATCAACCTCTCCAT
ps_bridge763	AACCTCACCTCACCATTCTATCTTCATCTACCACTTCTCTTATTCT
ps_bridge764	CCTCAACCAACCATAACCATTCATCTCATCCAACTCCAAACCACTC
ps_bridge765	CCTTAACCAACTTAACCACTAATCCTCACACCACAACTTTCATCAA
ps_bridge766	TTTAACCACTCACTTTCTACACCAACAATCAACTTCAACACACTAC
ps_bridge767	TCTCACAAATCACTTCACTCACCATAACCAAACACTCTTACCTTCA
ps_bridge768	ACTCACCATTTCTTCTCAACCTTATACATATTCCACAACTCCTACC
ps_bridge769	ATATATCTCTTCACCTCTCCACCAAATATTACACATCCACACCAAA
ps_bridge770	CTCACTACCACACAACTTTCACTCCTCACTTCACTTCCACCATACT
ps_bridge771	TTCACTCCTATTCAATCACCATTACATTCACCATCCAAATTCCTCT
ps_bridge772	AACACATTCAACCACATAACTTAAACATCACTCCATCAACCAAACC
ps_bridge773	CACCAAATTATCTTCATCACCACATATCTCACACTTTCTCACCAAC
ps_bridge774	TCACCTTCTCACTCCTTCATCTCTAACTCCTCTAATACTTCAAACT
ps_bridge775	CCACCTCACATCAACTCACATTACCATCCATCACTTCTACAACAAC
ps_bridge776	TTCATCCACCACATACCTAAACCAATCAACAAATCCTCTATAACCT
ps_bridge777	TTCCTACTCAACATCCTCACAACACTTCATCCACATATTCCTCTAT
ps_bridge778	CTACAACCTTCCTACTTTCTTCTCCAATCCACACAATAACAACCAA
ps_bridge779	AACATACCACTCAACACAATTACATCATACTCCACATCCATACACT
ps_bridge780	CTCCAATATACTAAACCTCAACCACTTTCCACTATCACACCAACTT
ps_bridge781	ACCTTACACTATACAATTCACCAACCATCCTCTCCTATCACTTACT
ps_bridge782	CTTCAATCCTTTAAATCCACATTCAACCACTACAACATCTCCTCCA
ps_bridge783	ACCACATTCAACAATTCTCCACACAACTTCTTACCTCTCTATCATA
ps_bridge784	TCCACTCTATTCTCAACATTTCATTTAACTCACTCATTCCACCACT
ps_bridge785	CATCACTCTCATCATTCCTCAATTTCCACTTACTTCCTACCACTCC
ps_bridge786	TTCTTATCACTCCATACAACCATTCTTCTTCCATACACTCCAACAC
ps_bridge787	ACTCACAAACCTTCACACTAACTATACACCACTCTCTTCCTTAACC
ps_bridge788	CTTCTCAACTCTTCCTACCTCACCTCATCACAATCCATCCTTATTA
ps_bridge789	CTCAAATCTCCAAACTCCATTCCTTATTTCACTCCAACTCTCAACT
ps_bridge790	TACCACAACATAACTAAATCCACTCTCTCATATCCACCTTTCCTTC
ps_bridge791	CCAACACACCACTACTCCAATACATAACCATTAACCTACTCCAAAC
ps_bridge792	AATCCATTCCTACACCACCAACCAAACACATTACCTTATTCATCTA
ps_bridge793	TATACATATCATACCAACCTTTCCACTACCTCAACCACTTCCACAC
ps_bridge794	AATAACCTTAAACCACTACTTCACTCTCACACACTATCACTCCTCT
ps_bridge795	ACTCAACTCCATCTCATATCATCCACCTAAACATACATCAATCTCC
ps_bridge796	ACTTCAACTCAATACTCCTCCTTCCACACAACACCTTACTCATATA
ps_bridge797	TACCTCTTTCCTCTTACTCATCATTACCTTCTCCAATCACTCTCCA
ps_bridge798	TTCCACCTACTACCATATACTCTATCCTCTCTTACTAACCACTCCA
ps_bridge799	CTCTCACAACTATCCTAAATTCCTCTCTACCTATCAACACAACCAC
ps_bridge800	AACACATCACATTACCACCAAACTCATACTCCATTACCTCCACCTA
